1111111111111
100800C0010C1
1108001011001
1C18110000E01
1111111111111