1111111111111
10010P0E01001
110C001011001
1P10110000001
1111111111111