1111111111111111111111
11010000C0000C00010001
1010010000000000010001
11111000C0000P00000001
111E000000000000000011
1111100001000000011001
1111111111111111111111