11111111111111111111111111111111111
10C00E00000000P00000000000000000011
11111111111111111111111011111111111
11111111111111111111111001110111111
11111111111111111111111111111111111